#############################################################################################################################################
#.#.................#...........#.........#.....#.......#.......#.......#.........#.....#...#.................#.........#.......#..........E#
#.#.###.###.#######.###.#####.###.#####.#.###.#.###.#.#.#.#.###.#.#####.#.#####.#.#.#.#.#.#.#.#########.#.#.#.#.###.###.#.###.#.###.###.#.###
#...#.#.....#...#.......#...#.#...#.....#.....#.#...#.#...#...#.#.....#.#...#...#...#.#...#.#...#.......#.#.#.#...#.#...#.#...#...#.....#...#
#.###.#.#.###.#.#########.#.###.###.###########.#.#.#.#######.#.#####.#####.#.#.#####.#####.#####.###.#.###.#.#####.#.###.#.#####.#.###.###.#
#.#...#.......#...........#...#...#...#.#.........#.......#...#.....#.......#.#.....#.#.#...#.....#...#...#.#.......#.......................#
#.###.#######################.###.###.#.#.###.#######.###.#.#######.#########.#####.#.#.#.###.#####.#.###.#.#########.#########.###.#########
#.....#...............#.#.....#.#.#.#.#.....#...#...#.......#...#.......#...#.....#...#.....................#.......#...........#.....#.....#
#####.#######.#######.#.#.###.#.#.#.#.#######.#.#.#.#.#######.#.#######.#.#.#####.#############.#.###.###.#.###.###.#.###########.#.#.#.###.#
#...#.........#.....#.#.#.#.....#.#.#.........#.........................#.#.....#.#...#...#.....#.#.#.....#...#...#...#.......#...#.#...#.#.#
###.#############.###.#.#.#######.#.###.###.#.#.#.#.#.#.#.#######.#.#.###.#####.#.#.#.#.#.#####.#.#.#.#######.###.#.###.#####.#.###.#####.#.#
#...#...#.........#...#.#.......#...#...........................#.#.#.#...#.......#.#...#...#...#.....#.......#...#.#.#.#...#...............#
#.#.#.###.#####.###.###.#######.###.#.#######.#.#.#.#.###.###.#.#.#.#.#.###.#######.#######.#.#######.#.#######.###.#.#.#.#.#####.#.#.#.#.#.#
#.#...#...#...#...................#.#.#.......#.#.#.#.........#.#.#...#.#.#...#...#.#.#...#.#.#.......#...............#.#.#.......#...#...#.#
#.###.#.#####.#######.#.#.#.#.#.###.#.#.#####.#.#.#.#.###########.#.###.#.#.###.#.#.#.#.#.#.#.#.#######.###########.###.#.#########.#####.#.#
#.#.#.#.....#.....#.....#.#...#.....#.#.......#...#.#.#.#.........#...#.#...#...#...#.#.#...#.#.#.......#...#...........#.....#.....#.#...#.#
#.#.#.#####.#.###.#####.#.###########.#######.#####.#.#.#.###########.#.#####.#######.#.#####.#.#.###.###.#.#.#################.#####.#.###.#
#.#.......#.#...#.....#.#...........#.#.......#...#...#.#...#...........#...#.........#.#...#...#.#...#...#.#...#.............#...#.#...#...#
#.#########.#.#.#####.#.###########.#.#.#######.#.#.###.###.#.###########.#.#######.#.#.#.###.#####.###.###.###.#.#.#########.###.#.#.###.###
#...........#.#.....#.#.#...........#.......#...#.#.....#...#.#...........#...#.....#...#.#...#...#.#...#.#...#.#.#...#.#.........#.....#...#
#.###########.#####.#.###.#####.#############.###.#######.#####.#############.#.#####.###.#.###.#.#.#.###.###.#.#####.#.#.#########.#######.#
#...#.......#.#.#...#...#.#...#.#...........#.#.#.#.....#.#...#.#.........#...#.#...#...#.#...#.#.#.#.......#.............#...#...#.#.....#.#
###.#.###.###.#.#.#####.#.#.#.###.#########.#.#.#.#.#.#.#.#.#.#.#.###.###.#.###.#.#.###.#.###.#.#.#.#.#########.#####.###.#.#.#.#.#.#.###.#.#
#.#.#...#.......#.....#.#...#...#...#.#.....#.#...#.#.....#.#...#...#.#...#.....#.#...#.#...#...#.#...#.......#.#.....#...#.#.#.#...#...#.#.#
#.#.###.###########.#.#.#######.###.#.#.#####.#.###.#.#####.#######.#.#############.###.#.#######.###.#.#####.###.###.#.#.#.#.#########.#.#.#
#.#...#...#.#.......#.......#.....#.#.........#.....#...#...#...#...#.......#.......#...#...#...#...#.#.#.......#.#.....#...#.....#.....#...#
#.###.###.#.#.#############.#.#####.#.#################.#.###.#.#.#########.#.#.###.#.###.#.#.#.###.###.#######.#.#.#############.#.#########
#...#.#.#...#.........#.....#.#...#.......#.......#...#.#.....#.#.#...#...#...#.#...#.#...#...#...#...#.#.....#...#...#...#.......#.........#
#.###.#.###.#########.###.###.#.#.#######.#.#####.#.#.#.#####.#.###.#.#.#.#####.#####.#.#####.#.#####.#.#.###.#######.#.#.#.#######.#######.#
#...#.#.#...#.....#.#...#.#...#.#.#.....#.#.....#...#...#...#.#...#.#...#.....#.....#.#.......#.........#...#.#...#.....#.#...#...#.#.....#.#
###.#.#.#.#.#.###.#.###.#.#.#.#.#.#.###.#.#####.#########.#.#####.#.#.#######.#.###.#.#####.#####.#########.#.#.#.#.#####.###.###.#.###.#.#.#
#...#.#...#.....#.....#.#.....#.#...#.....#.......#...#...#.......#.#.#...#.#.#...#.....#...#...#...#.....#.#...#...#...#.#.#...#.......#.#.#
#.#.#.#.###.###.#.#.###.#####.#.###########.#######.#.#.###########.#.#.#.#.#.#####.###.#####.#.#####.###.#.#########.###.#.###.#########.#.#
#.#...#.#.....#.#...#...#...#.#.........#.#.#...#...#...#...........#...#.#...........#.......#.......#.#.#...#...#...........#.#.....#...#.#
#.#.###.#.#.#.#.#.#.#.#.#.#.###########.#.#.###.#.#######.#####.###.#.###.#######.#####################.#.###.###.#.#######.###.#.###.#.###.#
#...............#.#.#.....#.........#...#.......#...#...#.#...#...#.....#.......#.#.........#.#.........#.#...#...#...#.#.....#.#...........#
#.#.#.###.#.#####.#.#.###.#####.#####.#.#####.#.###.#.#.###.#.#########.#######.###.#####.#.#.#.#.#.###.#.#.###.#####.#.#.###.#.###.#.#####.#
#.#.......#.......#.#...#.....#...#...#.#...#.....#...#.....#.........#.......#.........#.#.#.#.#.#...#.#.#.#...#...#.#.....#...#...#.#.....#
#.#.#######.#######.###.#.#.#####.#.#####.#.#####.###################.#.#######.#########.#.#.#.#.###.###.#.#.###.#.#.#####.#####.###.#.#####
#.#.......#.#.....#...#...#.#...#.#.#...#.#.#.#...#.......#.........#.#.#.....#.#...#...#.#...#.#...#...#...#.#...#.#.....#.......#.....#...#
#.#.#####.#.#.###.###.###.###.#.#.#.#.#.#.#.#.#.###.###.#.#######.###.#.#.###.###.#.#.#.#.###.#.#.#.###.#####.#.###.#####.###.###########.#.#
#...#...#...#.......#...#.#...#...#...#...#.#.#.#.#.#...#.......#.#...#.#.#.#.....#...#.#...#.#...#...#...#.....#.#...#...#...#...........#.#
###.#.#####.#.###.#.###.#.#.#####.#########.#.#.#.#.#.#.#######.#.#.#####.#.#####.#####.#.#.###.#####.###.#.#####.###.#.#####.#.###.#####.#.#
#...#.......#.#...#.#.....#.#...#.#.....#...#...#...#.#.#.....#...#.....#.........#...#.#.#...............#.#...#.#...#.....#.#.#.......#...#
#.#.#####.#.###.#####.#####.#.#.#.#####.#.###.###.#.#.###.###.#####.###.#.#########.#.#.#.#############.#.#.#.#.#.#.#######.###.#####.#.#.###
#.#...#...#.....#...#...#...#.#.......#.#.#.#.#.....#...#.#.......#.#.#.#.#.....#...#.#.#...#.......#...#.#...#...#.#.........#...#...#.#...#
#.#.#.#.#.#.#.###.#.###.#.#.#########.#.#.#.#.#.#####.#.#.#######.#.#.#.#.#.#.#.#.###.#.#####.#####.#.#########.###.#.###.###.###.#.#####.#.#
#.......#.....#...#.........#.....#.#.#.#.#.#.#.....#...#...#...#.#.#.#.#.....#.....#.#.......#.#...#...........#.......#...#.....#.........#
#.#######.#####.#########.###.###.#.#.#.#.#.#.#.###.#.#.###.#.#.#.#.#.#.#.###.#######.#########.#.#######.#.#####.#.###.###.#######.#####.###
#...#...#.....#.......#.......#.#.#.#...#.#.#.#.....#.#...#.#.#...#...#...#.#.#.#.....#...#.....#.........#.#...#.#...#.#.#.......#.....#...#
#.#.#.#.###.#######.###.#######.#.#.#.###.#.#.#.###.#.###.#.#.###.###.###.#.#.#.#.#######.#.#.#####.#####.#.###.#.#####.#.###.###.#####.#.#.#
#.#...#...#.#.....#.#...#.......#.#.#.#...#.#...#.#.#...#.#.....#.#.#...#.#.....#.......#...#...........#.#.....#...........#.#.#.#.#...#.#.#
#.#######.#.#.###.#.#.###.###.###.#.#.#.###.#####.#.###.#.#####.#.#.###.#.#####.#######.#.#########.#####.#####.#############.#.#.#.#.#.#.#.#
#.....#.....#.#.#...#...#.#.#.......#.#.#.........#.....#.#.....#.#...#.#...#.#...#...#.#.......#.#...#...#.....#.........#...#.#...#...#.#.#
#####.#.###.#.#.#######.#.#.#.#.###.#.#.###.#.###########.#.#####.#.#.#.###.#.###.#.#.#.#######.#.###.#.###.###.#.#####.#.#.###.#.#.###.#.###
#...#.#.#...#.#.....#.#.#.#.#.#.#.....#...#.#.........#...#...#...#.#...#...#...#...#.#...#...#.....#.#.....#.....#.....#.#.#...#...#...#...#
#.#.#.#.#####.#.###.#.#.#.#.#.#.#######.#.#####.###.###.#####.#.#########.###.#####.#.###.###.#####.#.#.#######.###.###.#.#.###.#.###.###.#.#
#.#.#.#.....#.#.#.......#.#...#.#.......#.....#.#.#.........#.#...#.......#.#...#...#.#...#...#.....#...#.........#...#.......#...#...#.....#
#.###.#####.#.#.#######.#.#####.#.###.#.#####.#.#.#.#.###.###.###.#.#######.#.#.#.#.#.#.###.###.#########.#######.###.#.#####.#.#.#.#####.#.#
#.......#...#.#.....#...#...#...#.#.#.#.#...#.#.#.#.....#.#...#.....#.....#.#.#...#...#.#...#...#...#.....#.....#.#...#.....#.#.#...#.....#.#
#.#######.#.#.#.###.#.#####.#.###.#.#.#.#.###.#.#.#.###.###.###.###.#.###.#.#.#########.###.#.###.#.#.#########.#.#.#.#####.#.#.#.###.#####.#
#...#.....#.#.#...#.#.....#.......#.#.#.#.#.......#...#...#...#.#...#.#.....#.....#...#...#.#.#...#.#.....#.....#...#...#...#.#.#.#.......#.#
###.#.#####.#.###.#.#####.###.###.#.#.#.#.#.#########.###.###.###.#.#.#.#########.#.#.###.#.#.#####.#####.#.###.#######.###.#.###.#.#####.###
#...........#...#.#.....#...#.#...#.#.#...#.................#.#...#.#.#.#.........#.#...#.#.#.#.......#...#...#.......#...#...#...#.#...#...#
#.#####.#.#.###.#.###.#.###.###.#.#.#.###.#######.#.###.###.#.#.###.#.###.#########.###.#.#.#.#.#####.#.###.#.#######.###.#####.###.#.#####.#
#...#...#.....#.#.....#...#...#.#...#.#...#.......#...#.#.#.#...#...#...#.#...#.....#.#...#.....#.....#...#.#.#.........#...#...#.#.#.....#.#
###.#.#####.###.#####.#.#####.#.#.#.#.#####.#########.#.#.#.#####.#.###.#.###.#.#####.#.#######.#####.###.###.#########.###.#.###.#.#.#.#.#.#
#.#.....#.#.#...#...#.#.....#...#.#.#.......#.....#...#.#.#.......#...#.....#.#.........#...#...#...#...#...#.........#...#.............#.#.#
#.#.###.#.#.#.#.#.#.#######.#####.#.#.#######.#.###.###.#.#######.###.#####.#.#.#.###.###.#.#####.#.#.#####.#########.###.#####.#.#####.###.#
#.....#.#...#.#...#.......#.#.....#...#...#...#.......#...#.#...#...#...#.#.#.#.#.#.......#.#.....#.#.#.....#.........#.......#.#...#...#...#
#.#####.#.#.#.###.#######.#.#.#########.#.#####.#.#.#####.#.#.#.#.#.###.#.#.#.#.###.#######.#.###.#.###.#.#.#.#.###.###.###.#.#.###.#.###.#.#
#.#.....#.#.......#.....#.#.#.........#.#.#...#...#.......#.#.#.#.#.#.#.#...#.#.....#.........#...#.....#...#.........#...#...#...#.#.#...#.#
#.#.#######.#######.###.#.#.#########.#.#.#.#.#####.###.###.#.#.#.#.#.###.###.###########.#####.#########.#.#####.#.#.#.###.###.#.#.#.#.#####
#.#.#...#.....#.....#.#.#.........#...#.#...#.#...#.........#.#...#...#...#...#.......#...#...........#...#.#...#.#...#...#...#.#.....#.#...#
###.#.#.#.#####.#####.#.###########.###.#####.#.#.#########.#.#.#######.###.###.#.###.#.#.#.#######.#.#.###.#.#.#.#.#####.###.#####.###.#.#.#
#...#.#...#.....#.....#.#...........#...#.#...#.#.........#.#.#.#...#...#...#...#...#...#.#.....#...#.#...#...#.#.#.#.......#...#.....#...#.#
#.###.#####.#####.#.#.#.#.#######.###.###.#.###.###.#######.#.###.#.#.###.###.#####.#####.###.###.#.#####.#####.###.#.#.###.###.#.#.#.#####.#
#.....#...#.#.#...#.#.#.#.....#...#...#...#.....#.#.........#.#...#.#...#.....#...#...#...#...#...#.#...#.....#.....#.#.#.....#...#.#.#...#.#
#.#######.#.#.#.#.#.#.#.###.#.#.###.#####.#######.###########.#.###.###.#.#####.#.#.#.#.###.#.#.#####.#.###.#.#######.#.###########.#.#.#.#.#
#...#.....#.#.....#.#.#...#.#.#...#.#.......#...#.......#...#...#.#.....#.#.....#.#.#.#.#...#...#...#.#.#.....#.....#.#.#...........#.#.#.#.#
###.#.#####.#######.#.###.###.###.#.#.#####.#.#.###.###.#.#.#####.#########.#####.###.#.#.#.#####.#.#.#.#.#.###.#.###.#.#.###.#####.#.#.#.#.#
#...#.#...#...#...#.#.......#.....#...#...#...#.....#...#.#...#.#...............#.....#.#.#.....#.#.#.#...#.#...#.#...#.#.#...#...#.#...#...#
#.###.#.#.###.#.#.#.#.#.###.#.#.#.#####.#.###########.###.###.#.#.#.#.###.#.#.#.#######.#.#####.#.#.#.#.#####.###.#.###.#.#.###.#.#.#####.#.#
#.....#.#...#...#.#...#.....#.#.#...#...#.......#...#...#.....#...#.....#...#.#.#.....#.#.#.......#.#...#.....#.#.#.#.#...#.#...#.#.#.....#.#
#####.#.###.###.#.#.#####.#####.###.#.#####.#####.#.###.#.#.###.#######.#####.#.###.#.#.###.#.#.###.###.#.#####.#.#.#.#####.#.#.#.#.#.#.#.#.#
#.#...#.....#.....#.....#.......#...#.#...#.......#.....#.#.#.........#.......#...#.#.....#.#.#...#...#...#.....#...#...#.....#.#.#...#.#...#
#.#.#####.#.#.#########.###.#.#######.#.#.#########.#.###.#.#############.#######.#######.#.#.#####.#.#####.#########.#.#.###.#.###.###.#.###
#.........#...#...#...#...#.#.#.......#.#.......#.....#...#.............#.....#...#.....#...#.......#.#.......#.......#.#...#.#...#.......#.#
#.#####.#######.#.###.###.#.###.#########.#.###.#.#####.###############.#######.###.###.#############.#.#####.#.#####.#.###.#.#.#.#.#####.#.#
#.#.#...#.......#...#.....#...#.........#.#.#...#.....#...#.#.........#.#.....#.....#...#.............#.....#...#...#.#...#...#.#.....#.#.#.#
#.#.#.#.#.#########.#####.###.#########.###.#.###.###.#.#.#.#.#######.#.#.###.#######.###.###############.#.#####.#.#.###.###.#.###.#.#.#.#.#
#...#.#.#.#...#...#.....#.#...#.......#.#...#.....#...#.#.#.....#.#...#...#...#.......#...#...............#.#...#.#.#...#...#.......#.#.#.#.#
###.#.#.#.#.###.#.#####.#.#.#.#.#.#####.#.###.###.#.###.#.#####.#.#.#######.###.#######.###.#.###########.###.#.#.#.#.#.#######.#.#.#.#.#.#.#
#...#.#.#.#.....#.....#.#...#.#.#.#.....#.#.....#.#.....#...#...#.#.#.....#.#...#.....#...#.#.#.........#...#.#...#.#.#.#.........#.#...#.#.#
#.###.#.#.#######.###.#.###.###.#.#.#####.#####.###.#####.#.#.###.#.#.###.#.#.###.###.###.###.#.###.###.###.#.#####.###.#.#####.###.###.#.#.#
#...#.#.#.#...#...#...#...#.#...#...#...#...#.....#.#.......#.#...#...#.#...#.......#.#.#.....#...#.....#...#.#...#...#.#.#...#.#...#.#.#.#.#
#####.#.#.#.#.#.#########.#.#.#########.#.#.#####.###.#######.#.#######.#######.#####.#.#####.#######.#.#.###.#.#####.#.#.#.#.#.#.###.#.#.#.#
#.....#...........#...#...#.#...#.......#.#.....#.....#.......................#.#.....#...#...#.....#.#...#...#.....#...#.#.#.....#...#.#...#
#.###.#.#####.#.#.#.#.#.###.###.#####.###.#####.###.###.###########.#####.###.###.#####.###.###.###.#.#####.###.#.#.###.#.#.###.###.###.#.#.#
#.....#...#.#.#.#.#.#...#.#.#.#.#...#.#...#...#.#.....#...........#...#.#.#.#.....#.....#...#.#.#.#.#.....#.#...#.#.......#.#...............#
#.###.###.#.#.###.#.#####.#.#.#.#.#.#.#.#####.#.#.###############.###.#.#.#.###########.#.###.#.#.#.#####.#.#.#.###.#####.###.#.#.###.#.#.#.#
#...#.#.#...#.......#.....#...#.#.#.#.....#...#.#...#...........#.#.....#.#.............#.#...#.#.#.#.....#.#.#...#...#.#.......#.#...#.#...#
#.###.#.###.#####.#.#####.###.#.#.#.#####.#.###.#.#.#.#####.#####.#.#####.#.#.#####.#####.###.#.#.#.#.#####.#.###.###.#.#########.#.###.#.#.#
#.#...#...#...#...#.....#.#...#...#...#...#...#...#.#.#...#...#...#...#...#.#.......#.....#...#.#...#.......#.....#.........................#
###.#.#.#.###.#.#######.#.#.###.#####.###.###.###.#.#.#.#.###.#.###.###.###.#####.#.#.#####.#.#.###.#######.###.#.###########.###.#########.#
#...#...#.#...#...#...#.#.#...#.....#...#...#...#.#.....#.#.#.#.#...#...#.#...#.#.#.#...#...#.#...#.#.........#.#...........#...#.#.....#...#
#.###.#.###.#####.#.#.#.#.###.#.#.#.###.###.#.###.#######.#.#.#.#####.###.###.#.#.###.#.#.#######.#.#########.#.#########.#.#.#.###.###.#.#.#
#.....#.....#.....#.#...#.#...#.#.#.#...#.#.#.#...#...#.....#.#...#...#.....#...#.......#...#.....#.......#...#.#...........#.#.#...#...#...#
#.###.#.#####.#####.#####.#.###.#.#.#.###.#.#.#.###.#.#####.#.###.#.###.#######.###########.#.#.#########.#.###.###.###########.#.###.#####.#
#.......#.....#.#...#.......#...#.#.#...#...#.......#...#...#...#...#.........#.....#.....#.#.#.#.....#...#...#...#...#.....#...#...#.....#.#
#.#.#.###.#####.#.#.#.###########.#.###.#.###.#########.#######.#####.#######.###.#.#.#.#.#.#.###.###.###.#####.#.###.#.###.#.#.#.#.###.#.#.#
#...#...#.......#...#...........#.#...#.#.........#...#.......#.....#.......#...#.#...#.#.#.#.......#...#.....#.#.#...#...#...#.#.#.#.#.#.#.#
#.###.#.###.#######.###########.#.#####.#.#########.#.###.###.#.#.#.#######.###.#.###.#.#.#.#.#########.#####.###.#.#####.#####.#.#.#.#.###.#
#.#.......#.#.......#.....#.......#.....#.#.....#...#...#...#.#.#.#.........#...#...#.#.#.....#.........#...#.#.....#.....#...#.#.#...#.....#
#.#.#.#####.#.#######.###.#######.#.#######.#.#.#.#####.#####.#.#.###########.###.#.###.#####.#.#########.###.#.###.#.#####.#.#.#.###.#.###.#
#.#.....#...#...#...#.#.#.#...#...#...#.....#.....#...#.......#...#.........#.#...#.....#...#.#...#...#.......#.#.#.#.#.....#.#.#...#...#...#
#.#####.#.#####.#.#.#.#.#.#.#.#.#####.#.#############.#.#######.#####.#######.#.#.#########.#.#.#.#.###.#######.#.#.#.###.#####.#.#.#.#.###.#
#...#.#.#.#...#...#.#...#...#.#.#...#.#.#.......#...#.....#.#...#...#...#.....#.#...#.....#.#.#.#.#.............#...#...#.#...#.#.....#.....#
###.#.#.#.#.#.#####.###.#####.###.#.#.#.#.#.###.#.#.#.###.#.#.###.#.###.#.#####.#.#.###.#.#.#.#.#.#######.#####.###.###.#.#.#.#.#.###.#####.#
#.#...#.#...#.....#...#.#...#.#...#.#.#.#.#.....#.#.#.#.....#.....#.....#.......#.#.....#.#.#...#.....#.#.....#...#.....#...#.#.#...#...#...#
#.###.#.#####.#####.###.#.#.#.#.###.#.#.#.#.#####.#.#.###.###.#.###.###.#########.#######.#.###.###.#.#.#####.###.#######.###.#.#.#.#.#.#.###
#...#.#.......#...#.....#.#.#.#...#.#.#...#.#.....#.#...#.#.....#.......#.........#.....#.....#.#...#.#.....#...#...#.....#.#...#.....#.#.#.#
#.#.#.#########.#.#.###.#.#.#.#.###.#.#.###.#.#####.#.#.###.#.###.#######.#######.#.###.#######.#.#.#.#.###.###.#.#.#.#####.#####.###.#.#.#.#
#.#...#.#.......#.....#.#.#.#...#...#.#.....#.#.....#.......#.....#.....#.#.......#.#.#.......#.#.#.#.#...#...#.#.#.#...#.............#.#.#.#
#.#####.#.###.#####.#.###.#.###.#.###.#.#####.#.###############.###.###.#.#.#######.#.#######.#.#.#.#.###.#.#.#.#.#.###.###.#.###.###.#.#.#.#
#.#.....#...#.#...#.......#...#.#...#.#.#.#...#.#...............#...#.#...#.#.......#.......#...#...#...#.#.#.#.#.#.#...#...#.#.....#...#...#
#.#.#.#.###.###.#.#.#########.#####.#.#.#.#.#.#.###.#########.###.###.#.#####.###.#.#####.#.#####.#####.#.#.###.###.#.###.#####.###.#####.#.#
#.#.#.#.#.#.....#...#.....#...#.....#...#...#.#.....#.............#.#...#.....#.#.#.......#.#.........#.#.#.........#.....#.......#.#.......#
#.#.#.#.#.#######.#.#.###.#.###.###.#.###.###.#######.#############.#.###.#.###.#.#.###.###.#######.#.#.#################.#.#.#####.#.###.###
#.#.#.#...#.......#...#.#.#.....#...#...#.#.#.#.........#.....#.....#.#.#.......#...#.....#.......#.#.#...#.............#.#...#.#...#.#.....#
#.###.###.#####.#.#.###.#.#######.#.#.#.#.#.#.#.#########.###.###.###.#.###.###.###.#.#.#.#######.###.###.#.###########.#####.#.#.#.#.###.#.#
#.....#...#...#.#.#.....#.#.....#.#.....#.........................#...#.#.....#.#.#...#.#.......#...#.#...#.....#...#.#.....#...#.#.#.#...#.#
#######.###.#.###.#.###.#.#.###.#.#.#######.#.#.#.###.#.###.###.#.#.###.#.#.###.#.#####.#####.#.###.#.#.#######.#.#.#.#####.###.#.###.#.#.#.#
#...............#.....#.#.#.....#...#.....#.#.#.#.#.#...#.....#.#.......#.#...#...#.....#...#.#...#...#.....#...#.#.......#.....#.....#.#...#
#.###.#########.#.#.###.#.###.#.###.#.#.###.#.#.#.#.#######.#.#.#######.#.#.#.###.#.###.#.#.#.#######.###.###.###.#######.#############.#.#.#
#...#...#.......#...#...#...#.#...............#.#.........#.#.#.....#...#...#...#.#...#...#...#.....#.#.................#.....#.......#.....#
###.#####.#######.#.#.#.###.###.###.#.#######.###########.#.#######.#.#.###.#.###.###.#.#####.#.###.#.#.###.###.###.#.#######.#.#####.#.#.#.#
#...#...#...#.....#...#.#.#...#...#.#...#...#.#.....#...#.#.......#...#.#...#.#...#...#...#...#.#.#.#.#.....#...#...#.#.....#...#...#.#.#...#
#.###.#.###.#.###.#.###.#.###.#.#.#.###.###.#.#.###.#.#.#.#######.#####.#.#.#.#.###.#.###.#####.#.#.#.#####.#.#.#.#####.###.#####.#.#.###.#.#
#S....#.......#.............#...#...........#.....#...#...............#.....#.......#...#.........#.............#.........#.......#.......#.#
#############################################################################################################################################